Event 	Event_Category
?	OTHER
APACHE COUNTY	OTHER
DENSE FOG	DUST / FOG
HEAVY MIX	OTHER
HIGH	OTHER
OTHER	OTHER
SEICHE	OTHER
HEAVY SEAS	SEAS
HIGH WAVES	SEAS
HAZARDOUS SURF	SEAS
HIGH TIDES	SEAS
   HIGH SURF ADVISORY	SEAS
MARINE ACCIDENT	SEAS
MARINE HAIL	SEAS
MARINE HIGH WIND	SEAS
MARINE MISHAP	SEAS
MARINE STRONG WIND	SEAS
MARINE THUNDERSTORM WIND	SEAS
MARINE TSTM WIND	SEAS
RIP CURRENT	SEAS
RIP CURRENTS	SEAS
RIP CURRENTS/HEAVY SURF	SEAS
ROGUE WAVE	SEAS
ROUGH SEAS	SEAS
ROUGH SURF	SEAS
 TSTM WIND	WIND
 TSTM WIND (G45)	WIND
GRADIENT WIND	WIND
GUSTY WIND	WIND
GUSTY WIND/HAIL	WIND
GUSTY WIND/HVY RAIN	WIND
GUSTY WIND/RAIN	WIND
GUSTY WINDS	WIND
HIGH  WINDS	WIND
HIGH WIND	WIND
HIGH WIND (G40)	WIND
HIGH WIND 48	WIND
HIGH WIND AND SEAS	WIND
HIGH WIND DAMAGE	WIND
HIGH WIND/BLIZZARD	WIND
HIGH WIND/HEAVY SNOW	WIND
HIGH WIND/SEAS	WIND
HIGH WINDS	WIND
HIGH WINDS HEAVY RAINS	WIND
HIGH WINDS/	WIND
HIGH WINDS/COASTAL FLOOD	WIND
HIGH WINDS/COLD	WIND
HIGH WINDS/HEAVY RAIN	WIND
HIGH WINDS/SNOW	WIND
DOWNBURST	WIND
FUNNEL CLOUD	WIND
STORM FORCE WINDS	WIND
STORM SURGE	WIND
STORM SURGE/TIDE	WIND
STRONG WIND	WIND
STRONG WINDS	WIND
NON TSTM WIND	WIND
NON-SEVERE WIND DAMAGE	WIND
NON-TSTM WIND	WIND
MICROBURST	WIND
MICROBURST WINDS	WIND
LANDSLIDE	LANDSLIDE
LANDSLIDES	LANDSLIDE
LANDSLUMP	LANDSLIDE
LANDSPOUT	LANDSLIDE
COASTAL SURGE	LANDSLIDE
MUD SLIDE	LANDSLIDE
MUD SLIDES	LANDSLIDE
MUD SLIDES URBAN FLOODING	LANDSLIDE
MUDSLIDE	LANDSLIDE
MUDSLIDES	LANDSLIDE
ROCK SLIDE	LANDSLIDE
ASTRONOMICAL HIGH TIDE	TIDE / FLOOD / SURF
ASTRONOMICAL LOW TIDE	TIDE / FLOOD / SURF
 FLASH FLOOD	TIDE / FLOOD / SURF
BEACH EROSION	TIDE / FLOOD / SURF
BREAKUP FLOODING	TIDE / FLOOD / SURF
COASTAL  FLOODING/EROSION	TIDE / FLOOD / SURF
COASTAL EROSION	TIDE / FLOOD / SURF
COASTAL FLOOD	TIDE / FLOOD / SURF
COASTAL FLOODING	TIDE / FLOOD / SURF
COASTAL FLOODING/EROSION	TIDE / FLOOD / SURF
COASTAL STORM	TIDE / FLOOD / SURF
COASTALSTORM	TIDE / FLOOD / SURF
EROSION/CSTL FLOOD	TIDE / FLOOD / SURF
FLASH FLOOD	TIDE / FLOOD / SURF
FLASH FLOOD - HEAVY RAIN	TIDE / FLOOD / SURF
FLASH FLOOD FROM ICE JAMS	TIDE / FLOOD / SURF
FLASH FLOOD LANDSLIDES	TIDE / FLOOD / SURF
FLASH FLOOD WINDS	TIDE / FLOOD / SURF
FLASH FLOOD/	TIDE / FLOOD / SURF
FLASH FLOOD/ STREET	TIDE / FLOOD / SURF
FLASH FLOOD/FLOOD	TIDE / FLOOD / SURF
FLASH FLOOD/LANDSLIDE	TIDE / FLOOD / SURF
FLASH FLOODING	TIDE / FLOOD / SURF
FLASH FLOODING/FLOOD	TIDE / FLOOD / SURF
FLASH FLOODING/THUNDERSTORM WI	TIDE / FLOOD / SURF
FLASH FLOODS	TIDE / FLOOD / SURF
FLOOD	TIDE / FLOOD / SURF
FLOOD & HEAVY RAIN	TIDE / FLOOD / SURF
FLOOD FLASH	TIDE / FLOOD / SURF
FLOOD/FLASH	TIDE / FLOOD / SURF
FLOOD/FLASH FLOOD	TIDE / FLOOD / SURF
FLOOD/FLASH/FLOOD	TIDE / FLOOD / SURF
FLOOD/FLASHFLOOD	TIDE / FLOOD / SURF
FLOOD/RIVER FLOOD	TIDE / FLOOD / SURF
FLOODING	TIDE / FLOOD / SURF
FLOODING/HEAVY RAIN	TIDE / FLOOD / SURF
FLOODS	TIDE / FLOOD / SURF
HEAVY SURF	TIDE / FLOOD / SURF
HEAVY SURF AND WIND	TIDE / FLOOD / SURF
HEAVY SURF COASTAL FLOODING	TIDE / FLOOD / SURF
HEAVY SURF/HIGH SURF	TIDE / FLOOD / SURF
HEAVY SWELLS	TIDE / FLOOD / SURF
HIGH SEAS	TIDE / FLOOD / SURF
HIGH SURF	TIDE / FLOOD / SURF
ICE JAM FLOOD (MINOR	TIDE / FLOOD / SURF
ICE JAM FLOODING	TIDE / FLOOD / SURF
ICE FLOES	TIDE / FLOOD / SURF
HIGH SWELLS	TIDE / FLOOD / SURF
HIGH WATER	TIDE / FLOOD / SURF
LAKE FLOOD	TIDE / FLOOD / SURF
LAKESHORE FLOOD	TIDE / FLOOD / SURF
MINOR FLOODING	TIDE / FLOOD / SURF
MAJOR FLOOD	TIDE / FLOOD / SURF
RAPIDLY RISING WATER	TIDE / FLOOD / SURF
RIVER AND STREAM FLOOD	TIDE / FLOOD / SURF
RIVER FLOOD	TIDE / FLOOD / SURF
RIVER FLOODING	TIDE / FLOOD / SURF
RURAL FLOOD	TIDE / FLOOD / SURF
HURRICANE	HURRICANE
HURRICANE EDOUARD	HURRICANE
HURRICANE EMILY	HURRICANE
HURRICANE ERIN	HURRICANE
HURRICANE FELIX	HURRICANE
HURRICANE GORDON	HURRICANE
HURRICANE OPAL	HURRICANE
HURRICANE OPAL/HIGH WINDS	HURRICANE
HURRICANE/TYPHOON	HURRICANE
HURRICANE-GENERATED SWELLS	HURRICANE
GUSTNADO	TORNADO
AVALANCE	AVALANCHE
AVALANCHE	AVALANCHE
BLACK ICE	COLD
COLD	COLD
COLD AIR TORNADO	COLD
COLD AND SNOW	COLD
COLD TEMPERATURE	COLD
COLD WAVE	COLD
COLD WEATHER	COLD
COLD/WIND CHILL	COLD
COLD/WINDS	COLD
DAMAGING FREEZE	COLD
FREEZE	COLD
FREEZING DRIZZLE	COLD
FREEZING FOG	DUST / FOG
FREEZING RAIN	COLD
FREEZING RAIN/SLEET	COLD
FREEZING RAIN/SNOW	COLD
FREEZING SPRAY	COLD
FROST	COLD
FROST/FREEZE	COLD
FROST\FREEZE	COLD
GLAZE	COLD
GLAZE ICE	COLD
GLAZE/ICE STORM	COLD
EXTENDED COLD	COLD
EXTREME COLD	COLD
EXTREME COLD/WIND CHILL	COLD
EXTREME WIND CHILL	COLD
EXTREME WINDCHILL	COLD
ICE ON ROAD	COLD
ICE ROADS	COLD
ICE STORM	COLD
ICE STORM/FLASH FLOOD	COLD
ICE/STRONG WINDS	COLD
ICY ROADS	COLD
HYPERTHERMIA/EXPOSURE	COLD
HYPOTHERMIA	COLD
HYPOTHERMIA/EXPOSURE	COLD
ICE	COLD
ICE AND SNOW	COLD
ICE JAM	COLD
FOG AND COLD TEMPERATURES	DUST / FOG
LOW TEMPERATURE	COLD
RECORD COLD	COLD
LIGHTING	THUNDERSTORM/LIGHTNING
LIGHTNING	THUNDERSTORM/LIGHTNING
LIGHTNING  WAUSEON	THUNDERSTORM/LIGHTNING
LIGHTNING AND HEAVY RAIN	THUNDERSTORM/LIGHTNING
LIGHTNING AND THUNDERSTORM WIN	THUNDERSTORM/LIGHTNING
LIGHTNING FIRE	THUNDERSTORM/LIGHTNING
LIGHTNING INJURY	THUNDERSTORM/LIGHTNING
LIGHTNING THUNDERSTORM WINDS	THUNDERSTORM/LIGHTNING
LIGHTNING.	THUNDERSTORM/LIGHTNING
LIGHTNING/HEAVY RAIN	THUNDERSTORM/LIGHTNING
LIGNTNING	THUNDERSTORM/LIGHTNING
THUDERSTORM WINDS	THUNDERSTORM/LIGHTNING
THUNDEERSTORM WINDS	THUNDERSTORM/LIGHTNING
THUNDERESTORM WINDS	THUNDERSTORM/LIGHTNING
THUNDERSNOW	THUNDERSTORM/LIGHTNING
THUNDERSTORM	THUNDERSTORM/LIGHTNING
THUNDERSTORM  WINDS	THUNDERSTORM/LIGHTNING
THUNDERSTORM DAMAGE TO	THUNDERSTORM/LIGHTNING
THUNDERSTORM HAIL	THUNDERSTORM/LIGHTNING
THUNDERSTORM WIND	THUNDERSTORM/LIGHTNING
THUNDERSTORM WIND (G40)	THUNDERSTORM/LIGHTNING
THUNDERSTORM WIND 60 MPH	THUNDERSTORM/LIGHTNING
THUNDERSTORM WIND 65 MPH	THUNDERSTORM/LIGHTNING
THUNDERSTORM WIND 65MPH	THUNDERSTORM/LIGHTNING
THUNDERSTORM WIND 98 MPH	THUNDERSTORM/LIGHTNING
THUNDERSTORM WIND G50	THUNDERSTORM/LIGHTNING
THUNDERSTORM WIND G52	THUNDERSTORM/LIGHTNING
THUNDERSTORM WIND G55	THUNDERSTORM/LIGHTNING
THUNDERSTORM WIND TREES	THUNDERSTORM/LIGHTNING
THUNDERSTORM WIND/ TREE	THUNDERSTORM/LIGHTNING
THUNDERSTORM WIND/ TREES	THUNDERSTORM/LIGHTNING
THUNDERSTORM WIND/AWNING	THUNDERSTORM/LIGHTNING
THUNDERSTORM WIND/HAIL	THUNDERSTORM/LIGHTNING
THUNDERSTORM WIND/LIGHTNING	THUNDERSTORM/LIGHTNING
THUNDERSTORM WINDS	THUNDERSTORM/LIGHTNING
THUNDERSTORM WINDS 13	THUNDERSTORM/LIGHTNING
THUNDERSTORM WINDS 63 MPH	THUNDERSTORM/LIGHTNING
THUNDERSTORM WINDS AND	THUNDERSTORM/LIGHTNING
THUNDERSTORM WINDS HAIL	THUNDERSTORM/LIGHTNING
THUNDERSTORM WINDS LIGHTNING	THUNDERSTORM/LIGHTNING
THUNDERSTORM WINDS.	THUNDERSTORM/LIGHTNING
THUNDERSTORM WINDS/ FLOOD	THUNDERSTORM/LIGHTNING
THUNDERSTORM WINDS/FLOODING	THUNDERSTORM/LIGHTNING
THUNDERSTORM WINDS/FUNNEL CLOU	THUNDERSTORM/LIGHTNING
THUNDERSTORM WINDS/HAIL	THUNDERSTORM/LIGHTNING
THUNDERSTORM WINDS53	THUNDERSTORM/LIGHTNING
THUNDERSTORM WINDSHAIL	THUNDERSTORM/LIGHTNING
THUNDERSTORM WINDSS	THUNDERSTORM/LIGHTNING
THUNDERSTORM WINS	THUNDERSTORM/LIGHTNING
THUNDERSTORMS	THUNDERSTORM/LIGHTNING
THUNDERSTORMS WIND	THUNDERSTORM/LIGHTNING
THUNDERSTORMS WINDS	THUNDERSTORM/LIGHTNING
THUNDERSTORMW	THUNDERSTORM/LIGHTNING
THUNDERSTORMWINDS	THUNDERSTORM/LIGHTNING
THUNDERSTROM WIND	THUNDERSTORM/LIGHTNING
THUNDERTORM WINDS	THUNDERSTORM/LIGHTNING
THUNERSTORM WINDS	THUNDERSTORM/LIGHTNING
SEVERE THUNDERSTORM	THUNDERSTORM/LIGHTNING
SEVERE THUNDERSTORM WINDS	THUNDERSTORM/LIGHTNING
SEVERE THUNDERSTORMS	THUNDERSTORM/LIGHTNING
SEVERE TURBULENCE	THUNDERSTORM/LIGHTNING
BLIZZARD	BLIZZARD
BLIZZARD/WINTER STORM	BLIZZARD
BLOWING SNOW	BLIZZARD
GROUND BLIZZARD	BLIZZARD
HEAVY SNOW AND HIGH WINDS	BLIZZARD
HEAVY SNOW AND STRONG WINDS	BLIZZARD
HEAVY SNOW/BLIZZARD	BLIZZARD
HEAVY SNOW/BLIZZARD/AVALANCHE	AVALANCHE
HEAVY SNOW/HIGH WINDS & FLOOD	BLIZZARD
HEAVY SNOW/WIND	BLIZZARD
HEAVY SNOW/WINTER STORM	BLIZZARD
BRUSH FIRE	FIRE
FOREST FIRES	FIRE
GRASS FIRES	FIRE
WILD FIRES	FIRE
WILD/FOREST FIRE	FIRE
WILD/FOREST FIRES	FIRE
WILDFIRE	FIRE
WILDFIRES	FIRE
BLOWING DUST	DUST / FOG
DENSE SMOKE	DUST / FOG
DUST DEVIL	DUST / FOG
DUST DEVIL WATERSPOUT	DUST / FOG
DUST STORM	DUST / FOG
DUST STORM/HIGH WINDS	DUST / FOG
FOG	DUST / FOG
DAM BREAK	OTHER
DROUGHT	HEAT
DROUGHT/EXCESSIVE HEAT	HEAT
DRY MICROBURST	WIND
DRY MIRCOBURST WINDS	WIND
DROWNING	OTHER
EXCESSIVE HEAT	HEAT
EXTREME HEAT	HEAT
HEAT	HEAT
HEAT WAVE	HEAT
HEAT WAVE DROUGHT	HEAT
HEAT WAVES	HEAT
RECORD HEAT	HEAT
RECORD/EXCESSIVE HEAT	HEAT
EXCESSIVE RAINFALL	RAIN
HEAVY PRECIPITATION	RAIN
HEAVY RAIN	RAIN
HEAVY RAIN AND FLOOD	RAIN
HEAVY RAIN/HIGH SURF	RAIN
HEAVY RAIN/LIGHTNING	RAIN
HEAVY RAIN/SEVERE WEATHER	RAIN
HEAVY RAIN/SMALL STREAM URBAN	RAIN
HEAVY RAIN/SNOW	RAIN
HEAVY RAINS	RAIN
HEAVY RAINS/FLOODING	RAIN
HEAVY SHOWER	RAIN
RAIN	RAIN
RAIN/SNOW	RAIN
RAIN/WIND	RAIN
RAINSTORM	RAIN
RECORD RAINFALL	RAIN
MIXED PRECIP	RAIN
MIXED PRECIPITATION	RAIN
LIGHT FREEZING RAIN	RAIN
EXCESSIVE SNOW	SNOW
FALLING SNOW/ICE	SNOW
HEAVY SNOW	SNOW
HEAVY SNOW SHOWER	SNOW
HEAVY SNOW SQUALLS	SNOW
HEAVY SNOW/FREEZING RAIN	SNOW
HEAVY SNOW/ICE	SNOW
HEAVY SNOW/SQUALLS	SNOW
HEAVY SNOWPACK	SNOW
HEAVY SNOW-SQUALLS	SNOW
LAKE EFFECT SNOW	SNOW
HEAVY LAKE SNOW	SNOW
LAKE-EFFECT SNOW	SNOW
LATE SEASON SNOW	SNOW
LIGHT SNOW	SNOW
LIGHT SNOWFALL	SNOW
RECORD SNOW	SNOW
SNOW	SNOW
SNOW ACCUMULATION	SNOW
SNOW AND HEAVY SNOW	SNOW
SNOW AND ICE	SNOW
SNOW AND ICE STORM	SNOW
SNOW FREEZING RAIN	SNOW
SNOW SQUALL	SNOW
SNOW SQUALLS	SNOW
SNOW/ BITTER COLD	SNOW
SNOW/ ICE	SNOW
SNOW/BLOWING SNOW	SNOW
SNOW/COLD	SNOW
SNOW/FREEZING RAIN	SNOW
SNOW/HEAVY SNOW	SNOW
SNOW/HIGH WINDS	SNOW
SNOW/ICE	SNOW
SNOW/ICE STORM	SNOW
SNOW/SLEET	SNOW
SNOW/SLEET/FREEZING RAIN	SNOW
SNOWMELT FLOODING	SNOW
HAIL	HAIL
HAIL 0.75	HAIL
HAIL 100	HAIL
HAIL 175	HAIL
HAIL 275	HAIL
HAIL 450	HAIL
HAIL 75	HAIL
HAIL DAMAGE	HAIL
HAIL/WIND	HAIL
HAIL/WINDS	HAIL
HAILSTORM	HAIL
SLEET	HAIL
SLEET/ICE STORM	HAIL
SMALL HAIL	HAIL
TIDAL FLOODING	TIDE / FLOOD / SURF
TORNADO	TORNADO
TORNADO F0	TORNADO
TORNADO F1	TORNADO
TORNADO F2	TORNADO
TORNADO F3	TORNADO
TORNADOES, TSTM WIND, HAIL	TORNADO
TORNDAO	TORNADO
TORRENTIAL RAINFALL	RAIN
TROPICAL DEPRESSION	WIND
TROPICAL STORM	WIND
TROPICAL STORM ALBERTO	WIND
TROPICAL STORM DEAN	WIND
TROPICAL STORM GORDON	WIND
TROPICAL STORM JERRY	WIND
TSTM WIND	WIND
TSTM WIND  (G45)	WIND
TSTM WIND (41)	WIND
TSTM WIND (G35)	WIND
TSTM WIND (G40)	WIND
TSTM WIND (G45)	WIND
TSTM WIND 40	WIND
TSTM WIND 45	WIND
TSTM WIND 55	WIND
TSTM WIND 65)	WIND
TSTM WIND AND LIGHTNING	WIND
TSTM WIND DAMAGE	WIND
TSTM WIND G45	WIND
TSTM WIND G58	WIND
TSTM WIND/HAIL	WIND
TSTM WINDS	WIND
TSTMW	OTHER
TSUNAMI	TIDE / FLOOD / SURF
TUNDERSTORM WIND	WIND
TYPHOON	THUNDERSTORM/LIGHTNING
UNSEASONABLY COLD	COLD
UNSEASONABLY WARM	HEAT
UNSEASONABLY WARM AND DRY	HEAT
URBAN AND SMALL	OTHER
URBAN AND SMALL STREAM FLOODIN	TIDE / FLOOD / SURF
URBAN FLOOD	TIDE / FLOOD / SURF
URBAN FLOODING	TIDE / FLOOD / SURF
URBAN FLOODS	TIDE / FLOOD / SURF
URBAN SMALL	TIDE / FLOOD / SURF
URBAN/SMALL STREAM	TIDE / FLOOD / SURF
URBAN/SMALL STREAM FLOOD	TIDE / FLOOD / SURF
URBAN/SML STREAM FLD	TIDE / FLOOD / SURF
VOLCANIC ASH	OTHER
WARM WEATHER	HEAT
WATERSPOUT	TORNADO
WATERSPOUT-	TORNADO
WATERSPOUT TORNADO	TORNADO
WATERSPOUT/ TORNADO	TORNADO
WATERSPOUT/TORNADO	TORNADO
WATERSPOUT-TORNADO	TORNADO
WET MICROBURST	WIND
WHIRLWIND	WIND
WIND	WIND
WIND AND WAVE	WIND
WIND DAMAGE	WIND
WIND STORM	WIND
WIND/HAIL	WIND
WINDS	WIND
WINTER STORM	WIND
WINTER STORM HIGH WINDS	WIND
WINTER STORMS	WIND
WINTER WEATHER	WIND
WINTER WEATHER MIX	WIND
WINTER WEATHER/MIX	WIND
WINTRY MIX	WIND
